************
*          *
*  *   *   *
*          *
*  *****   *
*          *
************
